00010001
00020002
00030003
00040004
00050005
00060006
00070007
00080008
00090009
00100000
00110001